NO /Users/hharit/Desktop/cub3d/textures/greenlight.xpm
SO /Users/hharit/Desktop/cub3d/textures/purplestone.xpm
WE /Users/hharit/Desktop/cub3d/textures/bluestone.xpm
EA /Users/hharit/Desktop/cub3d/textures/eagle.xpm

F 220,400,0
C 225,30,0

        1111111111111111111111111
        1000000000110000000000001
        101100000111000000N000001
        1001000000000000000000001
111111111011000001110000000000001
100000000011000001110111111111111
11110111111111011100000010001
11110111111111011101010010001
11000000110101011100000010001
10000000000000001100000010001
10000000000000001101010010001
1100000011010101111101111000111
11110111 1110101 101111010001
11111111 1111111 111111111111
